10 20 32 3 16
17	17	17	-1	-1	-1	17	17	42	42	42	17	17	-1	-1	-1	17	17	17	17
-1	-1	-1	-1	-1	-1	-1	-1	-1	-1	-1	-1	-1	-1	-1	-1	-1	-1	-1	-1
-1	-1	-1	-1	-1	-1	-1	-1	-1	-1	-1	-1	-1	-1	-1	-1	-1	-1	-1	-1
-1	17	17	17	17	17	17	17	-1	-1	-1	17	17	17	17	17	17	17	-1	-1
-1	-1	-1	-1	-1	-1	-1	-1	10	10	10	-1	-1	-1	-1	-1	-1	-1	-1	-1
-1	-1	-1	-1	-1	-1	-1	-1	10	10	10	-1	-1	-1	-1	-1	-1	-1	-1	-1
-1	17	17	17	17	17	17	17	-1	-1	-1	17	17	17	17	17	17	17	-1	-1
-1	-1	-1	-1	-1	-1	-1	-1	-1	-1	-1	-1	-1	-1	-1	-1	-1	-1	-1	-1
-1	-1	-1	-1	-1	-1	-1	-1	-1	-1	-1	-1	-1	-1	-1	-1	-1	-1	-1	-1
17	17	17	-1	-1	-1	17	17	42	42	42	17	17	-1	-1	-1	17	17	17	17
