10 20 32 3 16
24	24	24	24	24	-1	-1	-1	-1	-1	-1	24	24	24	24	24	24	24	24	24
-1	-1	-1	-1	-1	-1	-1	-1	-1	-1	-1	-1	-1	-1	-1	-1	-1	-1	-1	-1
-1	-1	-1	-1	-1	-1	-1	-1	-1	-1	-1	-1	-1	-1	-1	-1	-1	-1	-1	-1
-1	-1	-1	24	24	24	24	24	24	24	24	24	24	-1	-1	-1	-1	-1	-1	-1
-1	-1	-1	10	-1	10	-1	10	-1	10	-1	10	-1	-1	-1	-1	-1	-1	-1	-1
-1	-1	-1	-1	10	-1	10	-1	10	-1	10	-1	10	-1	-1	-1	-1	-1	-1	-1
-1	-1	-1	24	24	24	24	24	24	24	24	24	24	-1	-1	-1	-1	-1	-1	-1
-1	-1	-1	-1	-1	-1	-1	-1	-1	-1	-1	-1	-1	-1	-1	-1	-1	-1	-1	-1
-1	-1	-1	-1	-1	-1	-1	-1	-1	-1	-1	-1	-1	-1	-1	-1	-1	-1	-1	-1
24	24	24	24	24	-1	-1	-1	-1	-1	-1	24	24	24	24	24	24	24	24	24
