10 25 32
-1	-1	-1	-1	-1	-1	-1	-1	-1	-1	-1	-1	-1	-1	-1	-1	-1	-1	-1	-1	-1	-1	-1	-1	-1
-1	-1	-1	-1	6	-1	-1	-1	-1	-1	-1	-1	-1	-1	-1	-1	-1	-1	-1	-1	-1	-1	-1	-1	-1
-1	-1	-1	6	6	6	-1	-1	-1	-1	-1	-1	16	17	18	-1	-1	-1	30	-1	-1	-1	-1	-1	-1
-1	-1	-1	-1	6	-1	-1	-1	-1	-1	-1	-1	-1	-1	-1	-1	-1	-1	30	-1	-1	-1	-1	-1	-1
-1	-1	-1	-1	-1	-1	-1	-1	-1	-1	-1	-1	-1	-1	-1	-1	30	30	30	-1	-1	-1	-1	-1	-1
-1	-1	-1	-1	-1	-1	-1	-1	-1	-1	-1	-1	-1	-1	-1	-1	30	-1	-1	-1	-1	-1	-1	-1	0
-1	-1	-1	-1	-1	-1	-1	-1	-1	-1	-1	-1	-1	-1	30	30	30	-1	-1	-1	-1	-1	-1	-1	0
0	1	2	-1	-1	-1	-1	-1	-1	-1	-1	-1	-1	-1	-1	-1	-1	-1	-1	-1	-1	-1	-1	-1	0
20	21	22	-1	-1	-1	7	1	8	-1	7	8	-1	-1	-1	-1	-1	-1	-1	-1	-1	-1	-1	-1	0
20	21	22	-1	-1	26	27	21	28	1	27	28	29	-1	-1	-1	-1	-1	-1	-1	0	0	0	0	0
